{
  " ": "000",
  "!": "001",
  "\"": "002",
  "#": "003",
  "$": "004",
  "%": "005",
  "&": "006",
  "'": "007",
  "(": "008",
  ")": "009",
  "*": "010",
  "+": "011",
  ",": "012",
  "-": "013",
  ".": "014",
  "/": "015",
  "0": "016",
  "1": "017",
  "2": "018",
  "3": "019",
  "4": "020",
  "5": "021",
  "6": "022",
  "7": "023",
  "8": "024",
  "9": "025",
  ":": "026",
  ";": "027",
  "<": "028",
  "=": "029",
  ">": "030",
  "?": "031",
  "A": "032",
  "B": "033",
  "C": "034",
  "D": "035",
  "E": "036",
  "F": "037",
  "G": "038",
  "H": "039",
  "I": "040",
  "J": "041",
  "K": "042",
  "L": "043",
  "M": "044",
  "N": "045",
  "O": "046",
  "P": "047",
  "Q": "048",
  "R": "049",
  "S": "050",
  "T": "051",
  "U": "052",
  "V": "053",
  "W": "054",
  "X": "055",
  "Y": "056",
  "Z": "057",
  "[": "058",
  "\\": "059",
  "]": "060",
  "^": "061",
  "_": "062",
  "`": "063",
  "a": "064",
  "b": "065",
  "c": "066",
  "d": "067",
  "e": "068",
  "f": "069",
  "g": "070",
  "h": "071",
  "i": "072",
  "j": "073",
  "k": "074",
  "l": "075",
  "m": "076",
  "n": "077",
  "o": "078",
  "p": "079",
  "q": "080",
  "r": "081",
  "s": "082",
  "t": "083",
  "u": "084",
  "v": "085",
  "w": "086",
  "x": "087",
  "y": "088",
  "z": "089",
  "{": "090",
  "|": "091",
  "}": "092",
  "~": "093"
}
